#domain
hospital
#levelname
helpme2
#colors
blue: 0, 4, A, X, Y, D, O
red: 1,5, G, C, Z, E, F 
#initial
+++++++++++++
+           +
+ +++++++++++
+ + + FCGDEY+
+ + + +++++++
+0          +
+1          +
+++++++++++++
#goal
+++++++++++++
+         FG+
+ +++++++++++
+ +Y+       +
+ + + +++++++
+           +
+           +
+++++++++++++
#end