#domain
hospital
#levelname
SABoxAgents
#colors
blue: 0, A, B, C, D, E, F, G, H, I, J, X, K, L, M, N, T, O, P, Q, R, S, Z, Y
#initial
+++++++++++++++++++++
+++++++ TS+         +
+++++++ +++++++++++ +
+++++++ +++++       +
+++++++ +++++ +++++++
++                  +
+R               ZYX+
+ +++++        ++++++
+ +OPQN         MLKJ+
+ +++++  0   HI++++++
+ +HFED         GCBA+
+ +++++++++++++++++++
+       +++++++++++++
+++++++ +++++BOX+++++
+AAA    ++++AGENTS+++
+++++++++++++++++++++
#goal
+++++++++++++++++++++
+++++++   +TS       +
+++++++ +++++++++++ +
+++++++ +++++       +
+++++++ +++++ +++++++
++                  +
+                   +
+R+++++        ++++++
+ +             NOPQ+
+ +++++        ++++++
+ +ABCG        DEFHI+
+ +++++++++++++++++++
+       +++++++++++++
+++++++ +++++   +++++
+XYZ    ++++      +++
+++++++++++++++++++++
#end
