#domain
hospital
#levelname
SAThree
#colors
red: 0, F
blue: E, N, M
grey: B, S, R
#initial
+++++++++++++++++
+              0+
+       +F+     +
+   B    +      +
+          ++++++
+++ +   S   M   +
++  ++        +++
+  +E   +    RN +
+  +   + +      +
+               +
+++++++++++++++++
#goal
+++++++++++++++++
+               +
+       + +     +
+   B    +      +
+          ++++++
+++ +   S   M   +
++  ++        +++
+  +E   +    RN +
+  +   +F+      +
+               +
+++++++++++++++++
#end
